#########################
*************************
************************#
************************#
************************#
************************#
*************************
*************************
*************************
*************************
*************************
#************************
#************************
#************************
#************************
#************************
#************************
#************************
#************************
#************************
#************************
#************************
#************************
#************************
#########################
